11111111111111111111111
1C000000000000100000001
1000000000000000000C001
100000000011110000000Q1
10000000000001000000001
11011100Q01111000000001
1E00000000111100C0000Q1
111111110S011100P000001
10000000000001000000001
10C00000000001000000001
11011100Q0111100000C001
10000000000C00000000001
11111111111111111111111