111111111111111
100000Q0000C001
100C0000P0Q0001
11Q1110Q0011111
1E00000C0011111
111111111111111